11111111
1C010001
11100001
10000001
10000001
10000001
1P0011E1
11111111