11111111111111
1001000C000001
10000111110001
1P0011E0C0M001
11111111111111